0,0,0,0,0,0,0,0,0,0,0,0,0,0,0,0
0,0,0,0,0,0,0,0,0,0,0,0,0,0,0,0
0,0,0,0,0,0,0,0,0,0,0,0,0,0,0,0
0,0,0,0,4,1,1,1,1,1,1,4,0,0,0,0
0,0,0,0,4,0,0,0,0,0,0,4,0,0,0,0
0,0,0,0,4,0,0,0,0,0,0,4,0,0,0,0
0,0,0,0,4,0,0,0,0,0,0,4,0,0,0,0
0,0,0,0,4,0,0,0,0,0,0,4,0,0,0,0
0,0,0,0,4,0,0,0,0,0,0,4,0,0,0,0
0,0,0,0,4,3,3,3,3,3,3,4,0,0,0,0
0,0,0,0,4,3,3,3,3,3,3,4,0,0,0,0